time,event_id,source_event_id,element_name,element_type,log_type,balance,vector_total,vector,new_state
2025-01-01 00:00:01 UTC,_000000,_000001,Stock 1,VectorStock,add,1.0,1.0,"{""x"":0.1,""y"":0.4,""z"":0.5}",
2025-01-01 00:00:02 UTC,_000001,_000003,Stock 1,VectorStock,add,2.0,1.0,"{""x"":0.1,""y"":0.4,""z"":0.5}",
2025-01-01 00:00:03 UTC,_000002,_000005,Stock 1,VectorStock,add,3.0,1.0,"{""x"":0.1,""y"":0.4,""z"":0.5}",
2025-01-01 00:00:04 UTC,_000003,_000007,Stock 1,VectorStock,add,4.0,1.0,"{""x"":0.1,""y"":0.4,""z"":0.5}",
2025-01-01 00:00:05 UTC,_000004,_000009,Stock 1,VectorStock,add,5.0,1.0,"{""x"":0.1,""y"":0.4,""z"":0.5}",
2025-01-01 00:00:06 UTC,_000005,_000011,Stock 1,VectorStock,add,6.0,1.0,"{""x"":0.1,""y"":0.4,""z"":0.5}",
2025-01-01 00:00:07 UTC,_000006,_000013,Stock 1,VectorStock,add,7.0,1.0,"{""x"":0.1,""y"":0.4,""z"":0.5}",
2025-01-01 00:00:08 UTC,_000007,_000015,Stock 1,VectorStock,add,8.0,1.0,"{""x"":0.1,""y"":0.4,""z"":0.5}",
2025-01-01 00:00:09 UTC,_000008,_000017,Stock 1,VectorStock,add,9.0,1.0,"{""x"":0.1,""y"":0.4,""z"":0.5}",
2025-01-01 00:00:10 UTC,_000009,_000019,Stock 1,VectorStock,add,10.0,1.0,"{""x"":0.1,""y"":0.4,""z"":0.5}",
2025-01-01 00:00:11 UTC,_000010,_000021,Stock 1,VectorStock,add,11.0,1.0,"{""x"":0.1,""y"":0.4,""z"":0.5}",
2025-01-01 00:00:12 UTC,_000011,_000023,Stock 1,VectorStock,add,12.0,1.0,"{""x"":0.1,""y"":0.4,""z"":0.5}",
2025-01-01 00:00:13 UTC,_000012,_000025,Stock 1,VectorStock,add,13.0,1.0,"{""x"":0.1,""y"":0.4,""z"":0.5}",
2025-01-01 00:00:14 UTC,_000013,_000027,Stock 1,VectorStock,add,14.0,1.0,"{""x"":0.1,""y"":0.4,""z"":0.5}",
2025-01-01 00:00:15 UTC,_000014,_000029,Stock 1,VectorStock,add,15.0,1.0,"{""x"":0.1,""y"":0.4,""z"":0.5}",
2025-01-01 00:00:16 UTC,_000015,_000031,Stock 1,VectorStock,add,16.0,1.0,"{""x"":0.1,""y"":0.4,""z"":0.5}",
2025-01-01 00:00:17 UTC,_000016,_000033,Stock 1,VectorStock,add,17.0,1.0,"{""x"":0.1,""y"":0.4,""z"":0.5}",
2025-01-01 00:00:18 UTC,_000017,_000035,Stock 1,VectorStock,add,18.0,1.0,"{""x"":0.1,""y"":0.4,""z"":0.5}",
2025-01-01 00:00:19 UTC,_000018,_000037,Stock 1,VectorStock,add,19.000000000000004,1.0,"{""x"":0.1,""y"":0.4,""z"":0.5}",
2025-01-01 00:00:20 UTC,_000019,_000039,Stock 1,VectorStock,add,20.0,1.0,"{""x"":0.1,""y"":0.4,""z"":0.5}",
2025-01-01 00:00:21 UTC,_000020,_000041,Stock 1,VectorStock,add,21.000000000000004,1.0,"{""x"":0.1,""y"":0.4,""z"":0.5}",
2025-01-01 00:00:22 UTC,_000021,_000043,Stock 1,VectorStock,add,22.000000000000004,1.0,"{""x"":0.1,""y"":0.4,""z"":0.5}",
2025-01-01 00:00:23 UTC,_000022,_000045,Stock 1,VectorStock,add,23.000000000000004,1.0,"{""x"":0.1,""y"":0.4,""z"":0.5}",
2025-01-01 00:00:24 UTC,_000023,_000047,Stock 1,VectorStock,add,24.000000000000004,1.0,"{""x"":0.1,""y"":0.4,""z"":0.5}",
2025-01-01 00:00:25 UTC,_000024,_000049,Stock 1,VectorStock,add,25.000000000000004,1.0,"{""x"":0.1,""y"":0.4,""z"":0.5}",
2025-01-01 00:00:26 UTC,_000025,_000051,Stock 1,VectorStock,add,26.000000000000007,1.0,"{""x"":0.1,""y"":0.4,""z"":0.5}",
2025-01-01 00:00:27 UTC,_000026,_000053,Stock 1,VectorStock,add,27.000000000000007,1.0,"{""x"":0.1,""y"":0.4,""z"":0.5}",
2025-01-01 00:00:28 UTC,_000027,_000055,Stock 1,VectorStock,add,28.000000000000007,1.0,"{""x"":0.1,""y"":0.4,""z"":0.5}",
2025-01-01 00:00:29 UTC,_000028,_000057,Stock 1,VectorStock,add,29.000000000000007,1.0,"{""x"":0.1,""y"":0.4,""z"":0.5}",
2025-01-01 00:00:30 UTC,_000029,_000059,Stock 1,VectorStock,add,30.000000000000007,1.0,"{""x"":0.1,""y"":0.4,""z"":0.5}",
2025-01-01 00:00:31 UTC,_000030,_000061,Stock 1,VectorStock,add,31.000000000000007,1.0,"{""x"":0.1,""y"":0.4,""z"":0.5}",
2025-01-01 00:00:32 UTC,_000031,_000063,Stock 1,VectorStock,add,32.00000000000001,1.0,"{""x"":0.1,""y"":0.4,""z"":0.5}",
2025-01-01 00:00:33 UTC,_000032,_000065,Stock 1,VectorStock,add,33.00000000000001,1.0,"{""x"":0.1,""y"":0.4,""z"":0.5}",
2025-01-01 00:00:34 UTC,_000033,_000067,Stock 1,VectorStock,add,34.00000000000001,1.0,"{""x"":0.1,""y"":0.4,""z"":0.5}",
2025-01-01 00:00:35 UTC,_000034,_000069,Stock 1,VectorStock,add,35.00000000000001,1.0,"{""x"":0.1,""y"":0.4,""z"":0.5}",
2025-01-01 00:00:36 UTC,_000035,_000071,Stock 1,VectorStock,add,36.000000000000014,1.0,"{""x"":0.1,""y"":0.4,""z"":0.5}",
2025-01-01 00:00:37 UTC,_000036,_000073,Stock 1,VectorStock,add,37.000000000000014,1.0,"{""x"":0.1,""y"":0.4,""z"":0.5}",
2025-01-01 00:00:38 UTC,_000037,_000075,Stock 1,VectorStock,add,38.000000000000014,1.0,"{""x"":0.1,""y"":0.4,""z"":0.5}",
2025-01-01 00:00:39 UTC,_000038,_000077,Stock 1,VectorStock,add,39.000000000000014,1.0,"{""x"":0.1,""y"":0.4,""z"":0.5}",
2025-01-01 00:00:40 UTC,_000039,_000079,Stock 1,VectorStock,add,40.00000000000001,1.0,"{""x"":0.1,""y"":0.4,""z"":0.5}",
2025-01-01 00:00:41 UTC,_000040,_000081,Stock 1,VectorStock,add,41.00000000000001,1.0,"{""x"":0.1,""y"":0.4,""z"":0.5}",
2025-01-01 00:00:42 UTC,_000041,_000083,Stock 1,VectorStock,add,42.00000000000001,1.0,"{""x"":0.1,""y"":0.4,""z"":0.5}",
2025-01-01 00:00:43 UTC,_000042,_000085,Stock 1,VectorStock,add,43.0,1.0,"{""x"":0.1,""y"":0.4,""z"":0.5}",
2025-01-01 00:00:44 UTC,_000043,_000087,Stock 1,VectorStock,add,44.0,1.0,"{""x"":0.1,""y"":0.4,""z"":0.5}",
2025-01-01 00:00:45 UTC,_000044,_000089,Stock 1,VectorStock,add,45.0,1.0,"{""x"":0.1,""y"":0.4,""z"":0.5}",
2025-01-01 00:00:46 UTC,_000045,_000091,Stock 1,VectorStock,add,46.0,1.0,"{""x"":0.1,""y"":0.4,""z"":0.5}",
2025-01-01 00:00:47 UTC,_000046,_000093,Stock 1,VectorStock,add,47.0,1.0,"{""x"":0.1,""y"":0.4,""z"":0.5}",
2025-01-01 00:00:48 UTC,_000047,_000095,Stock 1,VectorStock,add,47.99999999999999,1.0,"{""x"":0.1,""y"":0.4,""z"":0.5}",
2025-01-01 00:00:49 UTC,_000048,_000097,Stock 1,VectorStock,add,48.99999999999999,1.0,"{""x"":0.1,""y"":0.4,""z"":0.5}",
2025-01-01 00:00:50 UTC,_000049,_000099,Stock 1,VectorStock,add,49.99999999999999,1.0,"{""x"":0.1,""y"":0.4,""z"":0.5}",
2025-01-01 00:00:51 UTC,_000050,_000101,Stock 1,VectorStock,add,50.999999999999986,1.0,"{""x"":0.1,""y"":0.4,""z"":0.5}",
2025-01-01 00:00:51.000000001 UTC,_000051,_000050,Stock 1,VectorStock,emit_change,,,,Normal
2025-01-01 00:00:51.000000001 UTC,_000052,_000001,Stock 1,VectorStock,remove,49.999999999999986,1.0000000000000002,"{""x"":0.09999999999999999,""y"":0.39999999999999997,""z"":0.5000000000000002}",
2025-01-01 00:00:51.000000002 UTC,_000053,_000052,Stock 1,VectorStock,emit_change,,,,Empty
2025-01-01 00:00:52 UTC,_000054,_000103,Stock 1,VectorStock,add,50.999999999999986,1.0,"{""x"":0.1,""y"":0.4,""z"":0.5}",
2025-01-01 00:00:52.000000001 UTC,_000055,_000054,Stock 1,VectorStock,emit_change,,,,Normal
2025-01-01 00:00:52.000000001 UTC,_000000,_000003,Stock 2,VectorStock,add,1.0000000000000002,1.0000000000000002,"{""x"":0.09999999999999999,""y"":0.39999999999999997,""z"":0.5000000000000002}",
2025-01-01 00:00:52.000000001 UTC,_000056,_000004,Stock 1,VectorStock,remove,49.999999999999986,1.0,"{""x"":0.09999999999999998,""y"":0.3999999999999999,""z"":0.5000000000000002}",
2025-01-01 00:00:52.000000002 UTC,_000057,_000056,Stock 1,VectorStock,emit_change,,,,Empty
2025-01-01 00:00:53 UTC,_000058,_000105,Stock 1,VectorStock,add,50.99999999999998,1.0,"{""x"":0.1,""y"":0.4,""z"":0.5}",
2025-01-01 00:00:53.000000001 UTC,_000059,_000058,Stock 1,VectorStock,emit_change,,,,Normal
2025-01-01 00:00:53.000000001 UTC,_000001,_000006,Stock 2,VectorStock,add,2.0,1.0,"{""x"":0.09999999999999998,""y"":0.3999999999999999,""z"":0.5000000000000002}",
2025-01-01 00:00:53.000000001 UTC,_000060,_000007,Stock 1,VectorStock,remove,49.99999999999998,1.0,"{""x"":0.09999999999999996,""y"":0.39999999999999986,""z"":0.5000000000000002}",
2025-01-01 00:00:53.000000002 UTC,_000061,_000060,Stock 1,VectorStock,emit_change,,,,Empty
2025-01-01 00:00:54 UTC,_000062,_000107,Stock 1,VectorStock,add,50.99999999999997,1.0,"{""x"":0.1,""y"":0.4,""z"":0.5}",
2025-01-01 00:00:54.000000001 UTC,_000063,_000062,Stock 1,VectorStock,emit_change,,,,Normal
2025-01-01 00:00:54.000000001 UTC,_000002,_000009,Stock 2,VectorStock,add,3.0,1.0,"{""x"":0.09999999999999996,""y"":0.39999999999999986,""z"":0.5000000000000002}",
2025-01-01 00:00:54.000000001 UTC,_000064,_000010,Stock 1,VectorStock,remove,49.99999999999997,1.0,"{""x"":0.09999999999999996,""y"":0.39999999999999986,""z"":0.5000000000000002}",
2025-01-01 00:00:54.000000002 UTC,_000065,_000064,Stock 1,VectorStock,emit_change,,,,Empty
2025-01-01 00:00:55 UTC,_000066,_000109,Stock 1,VectorStock,add,50.99999999999997,1.0,"{""x"":0.1,""y"":0.4,""z"":0.5}",
2025-01-01 00:00:55.000000001 UTC,_000067,_000066,Stock 1,VectorStock,emit_change,,,,Normal
2025-01-01 00:00:55.000000001 UTC,_000003,_000012,Stock 2,VectorStock,add,4.0,1.0,"{""x"":0.09999999999999996,""y"":0.39999999999999986,""z"":0.5000000000000002}",
2025-01-01 00:00:55.000000001 UTC,_000068,_000013,Stock 1,VectorStock,remove,49.99999999999997,0.9999999999999999,"{""x"":0.09999999999999994,""y"":0.39999999999999974,""z"":0.5000000000000002}",
2025-01-01 00:00:55.000000002 UTC,_000069,_000068,Stock 1,VectorStock,emit_change,,,,Empty
2025-01-01 00:00:56 UTC,_000070,_000111,Stock 1,VectorStock,add,50.99999999999997,1.0,"{""x"":0.1,""y"":0.4,""z"":0.5}",
2025-01-01 00:00:56.000000001 UTC,_000071,_000070,Stock 1,VectorStock,emit_change,,,,Normal
2025-01-01 00:00:56.000000001 UTC,_000004,_000015,Stock 2,VectorStock,add,5.0,0.9999999999999999,"{""x"":0.09999999999999994,""y"":0.39999999999999974,""z"":0.5000000000000002}",
2025-01-01 00:00:56.000000001 UTC,_000072,_000016,Stock 1,VectorStock,remove,49.99999999999997,0.9999999999999998,"{""x"":0.09999999999999992,""y"":0.3999999999999997,""z"":0.5000000000000002}",
2025-01-01 00:00:56.000000002 UTC,_000073,_000072,Stock 1,VectorStock,emit_change,,,,Empty
2025-01-01 00:00:57 UTC,_000074,_000113,Stock 1,VectorStock,add,50.99999999999997,1.0,"{""x"":0.1,""y"":0.4,""z"":0.5}",
2025-01-01 00:00:57.000000001 UTC,_000075,_000074,Stock 1,VectorStock,emit_change,,,,Normal
2025-01-01 00:00:57.000000001 UTC,_000005,_000018,Stock 2,VectorStock,add,6.0,0.9999999999999998,"{""x"":0.09999999999999992,""y"":0.3999999999999997,""z"":0.5000000000000002}",
2025-01-01 00:00:57.000000001 UTC,_000076,_000019,Stock 1,VectorStock,remove,49.99999999999997,0.9999999999999998,"{""x"":0.09999999999999992,""y"":0.3999999999999997,""z"":0.5000000000000002}",
2025-01-01 00:00:57.000000002 UTC,_000077,_000076,Stock 1,VectorStock,emit_change,,,,Empty
2025-01-01 00:00:58 UTC,_000078,_000115,Stock 1,VectorStock,add,50.99999999999997,1.0,"{""x"":0.1,""y"":0.4,""z"":0.5}",
2025-01-01 00:00:58.000000001 UTC,_000079,_000078,Stock 1,VectorStock,emit_change,,,,Normal
2025-01-01 00:00:58.000000001 UTC,_000006,_000021,Stock 2,VectorStock,add,7.0,0.9999999999999998,"{""x"":0.09999999999999992,""y"":0.3999999999999997,""z"":0.5000000000000002}",
2025-01-01 00:00:58.000000001 UTC,_000080,_000022,Stock 1,VectorStock,remove,49.99999999999997,0.9999999999999998,"{""x"":0.09999999999999992,""y"":0.3999999999999997,""z"":0.5000000000000002}",
2025-01-01 00:00:58.000000002 UTC,_000081,_000080,Stock 1,VectorStock,emit_change,,,,Empty
2025-01-01 00:00:59 UTC,_000082,_000117,Stock 1,VectorStock,add,50.99999999999997,1.0,"{""x"":0.1,""y"":0.4,""z"":0.5}",
2025-01-01 00:00:59.000000001 UTC,_000083,_000082,Stock 1,VectorStock,emit_change,,,,Normal
2025-01-01 00:00:59.000000001 UTC,_000007,_000024,Stock 2,VectorStock,add,7.999999999999999,0.9999999999999998,"{""x"":0.09999999999999992,""y"":0.3999999999999997,""z"":0.5000000000000002}",
2025-01-01 00:00:59.000000001 UTC,_000084,_000025,Stock 1,VectorStock,remove,49.99999999999997,0.9999999999999998,"{""x"":0.09999999999999992,""y"":0.3999999999999997,""z"":0.5000000000000002}",
2025-01-01 00:00:59.000000002 UTC,_000085,_000084,Stock 1,VectorStock,emit_change,,,,Empty
2025-01-01 00:01:00 UTC,_000086,_000119,Stock 1,VectorStock,add,50.99999999999997,1.0,"{""x"":0.1,""y"":0.4,""z"":0.5}",
2025-01-01 00:01:00.000000001 UTC,_000087,_000086,Stock 1,VectorStock,emit_change,,,,Normal
2025-01-01 00:01:00.000000001 UTC,_000008,_000027,Stock 2,VectorStock,add,8.999999999999998,0.9999999999999998,"{""x"":0.09999999999999992,""y"":0.3999999999999997,""z"":0.5000000000000002}",
2025-01-01 00:01:00.000000001 UTC,_000088,_000028,Stock 1,VectorStock,remove,49.99999999999997,0.9999999999999998,"{""x"":0.09999999999999992,""y"":0.3999999999999997,""z"":0.5000000000000002}",
2025-01-01 00:01:00.000000002 UTC,_000089,_000088,Stock 1,VectorStock,emit_change,,,,Empty
2025-01-01 00:01:01 UTC,_000090,_000121,Stock 1,VectorStock,add,50.99999999999997,1.0,"{""x"":0.1,""y"":0.4,""z"":0.5}",
2025-01-01 00:01:01.000000001 UTC,_000091,_000090,Stock 1,VectorStock,emit_change,,,,Normal
2025-01-01 00:01:01.000000001 UTC,_000009,_000030,Stock 2,VectorStock,add,9.999999999999996,0.9999999999999998,"{""x"":0.09999999999999992,""y"":0.3999999999999997,""z"":0.5000000000000002}",
2025-01-01 00:01:01.000000001 UTC,_000092,_000031,Stock 1,VectorStock,remove,49.99999999999997,0.9999999999999998,"{""x"":0.09999999999999992,""y"":0.3999999999999997,""z"":0.5000000000000002}",
2025-01-01 00:01:01.000000002 UTC,_000093,_000092,Stock 1,VectorStock,emit_change,,,,Empty
2025-01-01 00:01:02 UTC,_000094,_000123,Stock 1,VectorStock,add,50.99999999999997,1.0,"{""x"":0.1,""y"":0.4,""z"":0.5}",
2025-01-01 00:01:02.000000001 UTC,_000095,_000094,Stock 1,VectorStock,emit_change,,,,Normal
2025-01-01 00:01:02.000000001 UTC,_000010,_000033,Stock 2,VectorStock,add,10.999999999999996,0.9999999999999998,"{""x"":0.09999999999999992,""y"":0.3999999999999997,""z"":0.5000000000000002}",
2025-01-01 00:01:02.000000001 UTC,_000096,_000034,Stock 1,VectorStock,remove,49.99999999999997,0.9999999999999998,"{""x"":0.09999999999999992,""y"":0.3999999999999997,""z"":0.5000000000000002}",
2025-01-01 00:01:02.000000002 UTC,_000097,_000096,Stock 1,VectorStock,emit_change,,,,Empty
2025-01-01 00:01:03 UTC,_000098,_000125,Stock 1,VectorStock,add,50.99999999999997,1.0,"{""x"":0.1,""y"":0.4,""z"":0.5}",
2025-01-01 00:01:03.000000001 UTC,_000099,_000098,Stock 1,VectorStock,emit_change,,,,Normal
2025-01-01 00:01:03.000000001 UTC,_000011,_000036,Stock 2,VectorStock,add,11.999999999999996,0.9999999999999998,"{""x"":0.09999999999999992,""y"":0.3999999999999997,""z"":0.5000000000000002}",
2025-01-01 00:01:03.000000001 UTC,_000100,_000037,Stock 1,VectorStock,remove,49.99999999999997,0.9999999999999998,"{""x"":0.09999999999999992,""y"":0.3999999999999997,""z"":0.5000000000000002}",
2025-01-01 00:01:03.000000002 UTC,_000101,_000100,Stock 1,VectorStock,emit_change,,,,Empty
2025-01-01 00:01:04 UTC,_000102,_000127,Stock 1,VectorStock,add,50.99999999999997,1.0,"{""x"":0.1,""y"":0.4,""z"":0.5}",
2025-01-01 00:01:04.000000001 UTC,_000103,_000102,Stock 1,VectorStock,emit_change,,,,Normal
2025-01-01 00:01:04.000000001 UTC,_000012,_000039,Stock 2,VectorStock,add,12.999999999999996,0.9999999999999998,"{""x"":0.09999999999999992,""y"":0.3999999999999997,""z"":0.5000000000000002}",
2025-01-01 00:01:04.000000001 UTC,_000104,_000040,Stock 1,VectorStock,remove,49.99999999999997,0.9999999999999998,"{""x"":0.09999999999999992,""y"":0.3999999999999997,""z"":0.5000000000000002}",
2025-01-01 00:01:04.000000002 UTC,_000105,_000104,Stock 1,VectorStock,emit_change,,,,Empty
2025-01-01 00:01:05 UTC,_000106,_000129,Stock 1,VectorStock,add,50.99999999999997,1.0,"{""x"":0.1,""y"":0.4,""z"":0.5}",
2025-01-01 00:01:05.000000001 UTC,_000107,_000106,Stock 1,VectorStock,emit_change,,,,Normal
2025-01-01 00:01:05.000000001 UTC,_000013,_000042,Stock 2,VectorStock,add,13.999999999999995,0.9999999999999998,"{""x"":0.09999999999999992,""y"":0.3999999999999997,""z"":0.5000000000000002}",
2025-01-01 00:01:05.000000001 UTC,_000108,_000043,Stock 1,VectorStock,remove,49.99999999999997,0.9999999999999998,"{""x"":0.09999999999999992,""y"":0.3999999999999997,""z"":0.5000000000000002}",
2025-01-01 00:01:05.000000002 UTC,_000109,_000108,Stock 1,VectorStock,emit_change,,,,Empty
2025-01-01 00:01:06 UTC,_000110,_000131,Stock 1,VectorStock,add,50.99999999999997,1.0,"{""x"":0.1,""y"":0.4,""z"":0.5}",
2025-01-01 00:01:06.000000001 UTC,_000111,_000110,Stock 1,VectorStock,emit_change,,,,Normal
2025-01-01 00:01:06.000000001 UTC,_000014,_000045,Stock 2,VectorStock,add,14.999999999999993,0.9999999999999998,"{""x"":0.09999999999999992,""y"":0.3999999999999997,""z"":0.5000000000000002}",
2025-01-01 00:01:06.000000001 UTC,_000112,_000046,Stock 1,VectorStock,remove,49.99999999999997,0.9999999999999998,"{""x"":0.09999999999999992,""y"":0.3999999999999997,""z"":0.5000000000000002}",
2025-01-01 00:01:06.000000002 UTC,_000113,_000112,Stock 1,VectorStock,emit_change,,,,Empty
2025-01-01 00:01:07 UTC,_000114,_000133,Stock 1,VectorStock,add,50.99999999999997,1.0,"{""x"":0.1,""y"":0.4,""z"":0.5}",
2025-01-01 00:01:07.000000001 UTC,_000115,_000114,Stock 1,VectorStock,emit_change,,,,Normal
2025-01-01 00:01:07.000000001 UTC,_000015,_000048,Stock 2,VectorStock,add,15.999999999999995,0.9999999999999998,"{""x"":0.09999999999999992,""y"":0.3999999999999997,""z"":0.5000000000000002}",
2025-01-01 00:01:07.000000001 UTC,_000116,_000049,Stock 1,VectorStock,remove,49.99999999999997,0.9999999999999998,"{""x"":0.09999999999999992,""y"":0.3999999999999997,""z"":0.5000000000000002}",
2025-01-01 00:01:07.000000002 UTC,_000117,_000116,Stock 1,VectorStock,emit_change,,,,Empty
2025-01-01 00:01:08 UTC,_000118,_000135,Stock 1,VectorStock,add,50.99999999999997,1.0,"{""x"":0.1,""y"":0.4,""z"":0.5}",
2025-01-01 00:01:08.000000001 UTC,_000119,_000118,Stock 1,VectorStock,emit_change,,,,Normal
2025-01-01 00:01:08.000000001 UTC,_000016,_000051,Stock 2,VectorStock,add,16.999999999999993,0.9999999999999998,"{""x"":0.09999999999999992,""y"":0.3999999999999997,""z"":0.5000000000000002}",
2025-01-01 00:01:08.000000001 UTC,_000120,_000052,Stock 1,VectorStock,remove,49.99999999999997,0.9999999999999998,"{""x"":0.09999999999999992,""y"":0.3999999999999997,""z"":0.5000000000000002}",
2025-01-01 00:01:08.000000002 UTC,_000121,_000120,Stock 1,VectorStock,emit_change,,,,Empty
2025-01-01 00:01:09 UTC,_000122,_000137,Stock 1,VectorStock,add,50.99999999999997,1.0,"{""x"":0.1,""y"":0.4,""z"":0.5}",
2025-01-01 00:01:09.000000001 UTC,_000123,_000122,Stock 1,VectorStock,emit_change,,,,Normal
2025-01-01 00:01:09.000000001 UTC,_000017,_000054,Stock 2,VectorStock,add,17.999999999999993,0.9999999999999998,"{""x"":0.09999999999999992,""y"":0.3999999999999997,""z"":0.5000000000000002}",
2025-01-01 00:01:09.000000001 UTC,_000124,_000055,Stock 1,VectorStock,remove,49.99999999999997,0.9999999999999998,"{""x"":0.09999999999999992,""y"":0.3999999999999997,""z"":0.5000000000000002}",
2025-01-01 00:01:09.000000002 UTC,_000125,_000124,Stock 1,VectorStock,emit_change,,,,Empty
2025-01-01 00:01:10 UTC,_000126,_000139,Stock 1,VectorStock,add,50.99999999999997,1.0,"{""x"":0.1,""y"":0.4,""z"":0.5}",
2025-01-01 00:01:10.000000001 UTC,_000127,_000126,Stock 1,VectorStock,emit_change,,,,Normal
2025-01-01 00:01:10.000000001 UTC,_000018,_000057,Stock 2,VectorStock,add,18.999999999999993,0.9999999999999998,"{""x"":0.09999999999999992,""y"":0.3999999999999997,""z"":0.5000000000000002}",
2025-01-01 00:01:10.000000001 UTC,_000128,_000058,Stock 1,VectorStock,remove,49.99999999999997,0.9999999999999998,"{""x"":0.09999999999999992,""y"":0.3999999999999997,""z"":0.5000000000000002}",
2025-01-01 00:01:10.000000002 UTC,_000129,_000128,Stock 1,VectorStock,emit_change,,,,Empty
2025-01-01 00:01:11 UTC,_000130,_000141,Stock 1,VectorStock,add,50.99999999999997,1.0,"{""x"":0.1,""y"":0.4,""z"":0.5}",
2025-01-01 00:01:11.000000001 UTC,_000131,_000130,Stock 1,VectorStock,emit_change,,,,Normal
2025-01-01 00:01:11.000000001 UTC,_000019,_000060,Stock 2,VectorStock,add,19.999999999999993,0.9999999999999998,"{""x"":0.09999999999999992,""y"":0.3999999999999997,""z"":0.5000000000000002}",
2025-01-01 00:01:11.000000001 UTC,_000132,_000061,Stock 1,VectorStock,remove,49.99999999999997,0.9999999999999998,"{""x"":0.09999999999999992,""y"":0.3999999999999997,""z"":0.5000000000000002}",
2025-01-01 00:01:11.000000002 UTC,_000133,_000132,Stock 1,VectorStock,emit_change,,,,Empty
2025-01-01 00:01:12 UTC,_000134,_000143,Stock 1,VectorStock,add,50.99999999999997,1.0,"{""x"":0.1,""y"":0.4,""z"":0.5}",
2025-01-01 00:01:12.000000001 UTC,_000135,_000134,Stock 1,VectorStock,emit_change,,,,Normal
2025-01-01 00:01:12.000000001 UTC,_000020,_000063,Stock 2,VectorStock,add,20.999999999999993,0.9999999999999998,"{""x"":0.09999999999999992,""y"":0.3999999999999997,""z"":0.5000000000000002}",
2025-01-01 00:01:12.000000001 UTC,_000136,_000064,Stock 1,VectorStock,remove,49.99999999999997,0.9999999999999998,"{""x"":0.09999999999999992,""y"":0.3999999999999997,""z"":0.5000000000000002}",
2025-01-01 00:01:12.000000002 UTC,_000137,_000136,Stock 1,VectorStock,emit_change,,,,Empty
2025-01-01 00:01:13 UTC,_000138,_000145,Stock 1,VectorStock,add,50.99999999999997,1.0,"{""x"":0.1,""y"":0.4,""z"":0.5}",
2025-01-01 00:01:13.000000001 UTC,_000139,_000138,Stock 1,VectorStock,emit_change,,,,Normal
2025-01-01 00:01:13.000000001 UTC,_000021,_000066,Stock 2,VectorStock,add,21.999999999999993,0.9999999999999998,"{""x"":0.09999999999999992,""y"":0.3999999999999997,""z"":0.5000000000000002}",
2025-01-01 00:01:13.000000001 UTC,_000140,_000067,Stock 1,VectorStock,remove,49.99999999999997,0.9999999999999998,"{""x"":0.09999999999999992,""y"":0.3999999999999997,""z"":0.5000000000000002}",
2025-01-01 00:01:13.000000002 UTC,_000141,_000140,Stock 1,VectorStock,emit_change,,,,Empty
2025-01-01 00:01:14 UTC,_000142,_000147,Stock 1,VectorStock,add,50.99999999999997,1.0,"{""x"":0.1,""y"":0.4,""z"":0.5}",
2025-01-01 00:01:14.000000001 UTC,_000143,_000142,Stock 1,VectorStock,emit_change,,,,Normal
2025-01-01 00:01:14.000000001 UTC,_000022,_000069,Stock 2,VectorStock,add,22.999999999999993,0.9999999999999998,"{""x"":0.09999999999999992,""y"":0.3999999999999997,""z"":0.5000000000000002}",
2025-01-01 00:01:14.000000001 UTC,_000144,_000070,Stock 1,VectorStock,remove,49.99999999999997,0.9999999999999998,"{""x"":0.09999999999999992,""y"":0.3999999999999997,""z"":0.5000000000000002}",
2025-01-01 00:01:14.000000002 UTC,_000145,_000144,Stock 1,VectorStock,emit_change,,,,Empty
2025-01-01 00:01:15 UTC,_000146,_000149,Stock 1,VectorStock,add,50.99999999999997,1.0,"{""x"":0.1,""y"":0.4,""z"":0.5}",
2025-01-01 00:01:15.000000001 UTC,_000147,_000146,Stock 1,VectorStock,emit_change,,,,Normal
2025-01-01 00:01:15.000000001 UTC,_000023,_000072,Stock 2,VectorStock,add,23.999999999999993,0.9999999999999998,"{""x"":0.09999999999999992,""y"":0.3999999999999997,""z"":0.5000000000000002}",
2025-01-01 00:01:15.000000001 UTC,_000148,_000073,Stock 1,VectorStock,remove,49.99999999999997,0.9999999999999998,"{""x"":0.09999999999999992,""y"":0.3999999999999997,""z"":0.5000000000000002}",
2025-01-01 00:01:15.000000002 UTC,_000149,_000148,Stock 1,VectorStock,emit_change,,,,Empty
2025-01-01 00:01:16 UTC,_000150,_000151,Stock 1,VectorStock,add,50.99999999999997,1.0,"{""x"":0.1,""y"":0.4,""z"":0.5}",
2025-01-01 00:01:16.000000001 UTC,_000151,_000150,Stock 1,VectorStock,emit_change,,,,Normal
2025-01-01 00:01:16.000000001 UTC,_000024,_000075,Stock 2,VectorStock,add,24.999999999999993,0.9999999999999998,"{""x"":0.09999999999999992,""y"":0.3999999999999997,""z"":0.5000000000000002}",
2025-01-01 00:01:16.000000001 UTC,_000152,_000076,Stock 1,VectorStock,remove,49.99999999999997,0.9999999999999998,"{""x"":0.09999999999999992,""y"":0.3999999999999997,""z"":0.5000000000000002}",
2025-01-01 00:01:16.000000002 UTC,_000153,_000152,Stock 1,VectorStock,emit_change,,,,Empty
2025-01-01 00:01:17 UTC,_000154,_000153,Stock 1,VectorStock,add,50.99999999999997,1.0,"{""x"":0.1,""y"":0.4,""z"":0.5}",
2025-01-01 00:01:17.000000001 UTC,_000155,_000154,Stock 1,VectorStock,emit_change,,,,Normal
2025-01-01 00:01:17.000000001 UTC,_000025,_000078,Stock 2,VectorStock,add,25.999999999999993,0.9999999999999998,"{""x"":0.09999999999999992,""y"":0.3999999999999997,""z"":0.5000000000000002}",
2025-01-01 00:01:17.000000001 UTC,_000156,_000079,Stock 1,VectorStock,remove,49.99999999999997,0.9999999999999998,"{""x"":0.09999999999999992,""y"":0.3999999999999997,""z"":0.5000000000000002}",
2025-01-01 00:01:17.000000002 UTC,_000157,_000156,Stock 1,VectorStock,emit_change,,,,Empty
2025-01-01 00:01:18 UTC,_000158,_000155,Stock 1,VectorStock,add,50.99999999999997,1.0,"{""x"":0.1,""y"":0.4,""z"":0.5}",
2025-01-01 00:01:18.000000001 UTC,_000159,_000158,Stock 1,VectorStock,emit_change,,,,Normal
2025-01-01 00:01:18.000000001 UTC,_000026,_000081,Stock 2,VectorStock,add,26.999999999999993,0.9999999999999998,"{""x"":0.09999999999999992,""y"":0.3999999999999997,""z"":0.5000000000000002}",
2025-01-01 00:01:18.000000001 UTC,_000160,_000082,Stock 1,VectorStock,remove,49.99999999999997,0.9999999999999998,"{""x"":0.09999999999999992,""y"":0.3999999999999997,""z"":0.5000000000000002}",
2025-01-01 00:01:18.000000002 UTC,_000161,_000160,Stock 1,VectorStock,emit_change,,,,Empty
2025-01-01 00:01:19 UTC,_000162,_000157,Stock 1,VectorStock,add,50.99999999999997,1.0,"{""x"":0.1,""y"":0.4,""z"":0.5}",
2025-01-01 00:01:19.000000001 UTC,_000163,_000162,Stock 1,VectorStock,emit_change,,,,Normal
2025-01-01 00:01:19.000000001 UTC,_000027,_000084,Stock 2,VectorStock,add,27.999999999999993,0.9999999999999998,"{""x"":0.09999999999999992,""y"":0.3999999999999997,""z"":0.5000000000000002}",
2025-01-01 00:01:19.000000001 UTC,_000164,_000085,Stock 1,VectorStock,remove,49.99999999999997,0.9999999999999998,"{""x"":0.09999999999999992,""y"":0.3999999999999997,""z"":0.5000000000000002}",
2025-01-01 00:01:19.000000002 UTC,_000165,_000164,Stock 1,VectorStock,emit_change,,,,Empty
2025-01-01 00:01:20 UTC,_000166,_000159,Stock 1,VectorStock,add,50.99999999999997,1.0,"{""x"":0.1,""y"":0.4,""z"":0.5}",
2025-01-01 00:01:20.000000001 UTC,_000167,_000166,Stock 1,VectorStock,emit_change,,,,Normal
2025-01-01 00:01:20.000000001 UTC,_000028,_000087,Stock 2,VectorStock,add,28.999999999999993,0.9999999999999998,"{""x"":0.09999999999999992,""y"":0.3999999999999997,""z"":0.5000000000000002}",
2025-01-01 00:01:20.000000001 UTC,_000168,_000088,Stock 1,VectorStock,remove,49.99999999999997,0.9999999999999998,"{""x"":0.09999999999999992,""y"":0.3999999999999997,""z"":0.5000000000000002}",
2025-01-01 00:01:20.000000002 UTC,_000169,_000168,Stock 1,VectorStock,emit_change,,,,Empty
2025-01-01 00:01:21 UTC,_000170,_000161,Stock 1,VectorStock,add,50.99999999999997,1.0,"{""x"":0.1,""y"":0.4,""z"":0.5}",
2025-01-01 00:01:21.000000001 UTC,_000171,_000170,Stock 1,VectorStock,emit_change,,,,Normal
2025-01-01 00:01:21.000000001 UTC,_000029,_000090,Stock 2,VectorStock,add,29.999999999999993,0.9999999999999998,"{""x"":0.09999999999999992,""y"":0.3999999999999997,""z"":0.5000000000000002}",
2025-01-01 00:01:21.000000001 UTC,_000172,_000091,Stock 1,VectorStock,remove,49.99999999999997,0.9999999999999998,"{""x"":0.09999999999999992,""y"":0.3999999999999997,""z"":0.5000000000000002}",
2025-01-01 00:01:21.000000002 UTC,_000173,_000172,Stock 1,VectorStock,emit_change,,,,Empty
2025-01-01 00:01:22 UTC,_000174,_000163,Stock 1,VectorStock,add,50.99999999999997,1.0,"{""x"":0.1,""y"":0.4,""z"":0.5}",
2025-01-01 00:01:22.000000001 UTC,_000175,_000174,Stock 1,VectorStock,emit_change,,,,Normal
2025-01-01 00:01:22.000000001 UTC,_000030,_000093,Stock 2,VectorStock,add,30.999999999999993,0.9999999999999998,"{""x"":0.09999999999999992,""y"":0.3999999999999997,""z"":0.5000000000000002}",
2025-01-01 00:01:22.000000001 UTC,_000176,_000094,Stock 1,VectorStock,remove,49.99999999999997,0.9999999999999998,"{""x"":0.09999999999999992,""y"":0.3999999999999997,""z"":0.5000000000000002}",
2025-01-01 00:01:22.000000002 UTC,_000177,_000176,Stock 1,VectorStock,emit_change,,,,Empty
2025-01-01 00:01:23 UTC,_000178,_000165,Stock 1,VectorStock,add,50.99999999999997,1.0,"{""x"":0.1,""y"":0.4,""z"":0.5}",
2025-01-01 00:01:23.000000001 UTC,_000179,_000178,Stock 1,VectorStock,emit_change,,,,Normal
2025-01-01 00:01:23.000000001 UTC,_000031,_000096,Stock 2,VectorStock,add,32.0,0.9999999999999998,"{""x"":0.09999999999999992,""y"":0.3999999999999997,""z"":0.5000000000000002}",
2025-01-01 00:01:23.000000001 UTC,_000180,_000097,Stock 1,VectorStock,remove,49.99999999999997,0.9999999999999998,"{""x"":0.09999999999999992,""y"":0.3999999999999997,""z"":0.5000000000000002}",
2025-01-01 00:01:23.000000002 UTC,_000181,_000180,Stock 1,VectorStock,emit_change,,,,Empty
2025-01-01 00:01:24 UTC,_000182,_000167,Stock 1,VectorStock,add,50.99999999999997,1.0,"{""x"":0.1,""y"":0.4,""z"":0.5}",
2025-01-01 00:01:24.000000001 UTC,_000183,_000182,Stock 1,VectorStock,emit_change,,,,Normal
2025-01-01 00:01:24.000000001 UTC,_000032,_000099,Stock 2,VectorStock,add,33.0,0.9999999999999998,"{""x"":0.09999999999999992,""y"":0.3999999999999997,""z"":0.5000000000000002}",
2025-01-01 00:01:24.000000001 UTC,_000184,_000100,Stock 1,VectorStock,remove,49.99999999999997,0.9999999999999998,"{""x"":0.09999999999999992,""y"":0.3999999999999997,""z"":0.5000000000000002}",
2025-01-01 00:01:24.000000002 UTC,_000185,_000184,Stock 1,VectorStock,emit_change,,,,Empty
2025-01-01 00:01:25 UTC,_000186,_000169,Stock 1,VectorStock,add,50.99999999999997,1.0,"{""x"":0.1,""y"":0.4,""z"":0.5}",
2025-01-01 00:01:25.000000001 UTC,_000187,_000186,Stock 1,VectorStock,emit_change,,,,Normal
2025-01-01 00:01:25.000000001 UTC,_000033,_000102,Stock 2,VectorStock,add,34.0,0.9999999999999998,"{""x"":0.09999999999999992,""y"":0.3999999999999997,""z"":0.5000000000000002}",
2025-01-01 00:01:25.000000001 UTC,_000188,_000103,Stock 1,VectorStock,remove,49.99999999999997,0.9999999999999998,"{""x"":0.09999999999999992,""y"":0.3999999999999997,""z"":0.5000000000000002}",
2025-01-01 00:01:25.000000002 UTC,_000189,_000188,Stock 1,VectorStock,emit_change,,,,Empty
2025-01-01 00:01:26 UTC,_000190,_000171,Stock 1,VectorStock,add,50.99999999999997,1.0,"{""x"":0.1,""y"":0.4,""z"":0.5}",
2025-01-01 00:01:26.000000001 UTC,_000191,_000190,Stock 1,VectorStock,emit_change,,,,Normal
2025-01-01 00:01:26.000000001 UTC,_000034,_000105,Stock 2,VectorStock,add,35.0,0.9999999999999998,"{""x"":0.09999999999999992,""y"":0.3999999999999997,""z"":0.5000000000000002}",
2025-01-01 00:01:26.000000001 UTC,_000192,_000106,Stock 1,VectorStock,remove,49.99999999999997,0.9999999999999998,"{""x"":0.09999999999999992,""y"":0.3999999999999997,""z"":0.5000000000000002}",
2025-01-01 00:01:26.000000002 UTC,_000193,_000192,Stock 1,VectorStock,emit_change,,,,Empty
2025-01-01 00:01:27 UTC,_000194,_000173,Stock 1,VectorStock,add,50.99999999999997,1.0,"{""x"":0.1,""y"":0.4,""z"":0.5}",
2025-01-01 00:01:27.000000001 UTC,_000195,_000194,Stock 1,VectorStock,emit_change,,,,Normal
2025-01-01 00:01:27.000000001 UTC,_000035,_000108,Stock 2,VectorStock,add,36.0,0.9999999999999998,"{""x"":0.09999999999999992,""y"":0.3999999999999997,""z"":0.5000000000000002}",
2025-01-01 00:01:27.000000001 UTC,_000196,_000109,Stock 1,VectorStock,remove,49.99999999999997,0.9999999999999998,"{""x"":0.09999999999999992,""y"":0.3999999999999997,""z"":0.5000000000000002}",
2025-01-01 00:01:27.000000002 UTC,_000197,_000196,Stock 1,VectorStock,emit_change,,,,Empty
2025-01-01 00:01:28 UTC,_000198,_000175,Stock 1,VectorStock,add,50.99999999999997,1.0,"{""x"":0.1,""y"":0.4,""z"":0.5}",
2025-01-01 00:01:28.000000001 UTC,_000199,_000198,Stock 1,VectorStock,emit_change,,,,Normal
2025-01-01 00:01:28.000000001 UTC,_000036,_000111,Stock 2,VectorStock,add,37.0,0.9999999999999998,"{""x"":0.09999999999999992,""y"":0.3999999999999997,""z"":0.5000000000000002}",
2025-01-01 00:01:28.000000001 UTC,_000200,_000112,Stock 1,VectorStock,remove,49.99999999999997,0.9999999999999998,"{""x"":0.09999999999999992,""y"":0.3999999999999997,""z"":0.5000000000000002}",
2025-01-01 00:01:28.000000002 UTC,_000201,_000200,Stock 1,VectorStock,emit_change,,,,Empty
2025-01-01 00:01:29 UTC,_000202,_000177,Stock 1,VectorStock,add,50.99999999999997,1.0,"{""x"":0.1,""y"":0.4,""z"":0.5}",
2025-01-01 00:01:29.000000001 UTC,_000203,_000202,Stock 1,VectorStock,emit_change,,,,Normal
2025-01-01 00:01:29.000000001 UTC,_000037,_000114,Stock 2,VectorStock,add,38.0,0.9999999999999998,"{""x"":0.09999999999999992,""y"":0.3999999999999997,""z"":0.5000000000000002}",
2025-01-01 00:01:29.000000001 UTC,_000204,_000115,Stock 1,VectorStock,remove,49.99999999999997,0.9999999999999998,"{""x"":0.09999999999999992,""y"":0.3999999999999997,""z"":0.5000000000000002}",
2025-01-01 00:01:29.000000002 UTC,_000205,_000204,Stock 1,VectorStock,emit_change,,,,Empty
2025-01-01 00:01:30 UTC,_000206,_000179,Stock 1,VectorStock,add,50.99999999999997,1.0,"{""x"":0.1,""y"":0.4,""z"":0.5}",
2025-01-01 00:01:30.000000001 UTC,_000207,_000206,Stock 1,VectorStock,emit_change,,,,Normal
2025-01-01 00:01:30.000000001 UTC,_000038,_000117,Stock 2,VectorStock,add,39.0,0.9999999999999998,"{""x"":0.09999999999999992,""y"":0.3999999999999997,""z"":0.5000000000000002}",
2025-01-01 00:01:30.000000001 UTC,_000208,_000118,Stock 1,VectorStock,remove,49.99999999999997,0.9999999999999998,"{""x"":0.09999999999999992,""y"":0.3999999999999997,""z"":0.5000000000000002}",
2025-01-01 00:01:30.000000002 UTC,_000209,_000208,Stock 1,VectorStock,emit_change,,,,Empty
2025-01-01 00:01:31 UTC,_000210,_000181,Stock 1,VectorStock,add,50.99999999999997,1.0,"{""x"":0.1,""y"":0.4,""z"":0.5}",
2025-01-01 00:01:31.000000001 UTC,_000211,_000210,Stock 1,VectorStock,emit_change,,,,Normal
2025-01-01 00:01:31.000000001 UTC,_000039,_000120,Stock 2,VectorStock,add,40.0,0.9999999999999998,"{""x"":0.09999999999999992,""y"":0.3999999999999997,""z"":0.5000000000000002}",
2025-01-01 00:01:31.000000001 UTC,_000212,_000121,Stock 1,VectorStock,remove,49.99999999999997,0.9999999999999998,"{""x"":0.09999999999999992,""y"":0.3999999999999997,""z"":0.5000000000000002}",
2025-01-01 00:01:31.000000002 UTC,_000213,_000212,Stock 1,VectorStock,emit_change,,,,Empty
2025-01-01 00:01:32 UTC,_000214,_000183,Stock 1,VectorStock,add,50.99999999999997,1.0,"{""x"":0.1,""y"":0.4,""z"":0.5}",
2025-01-01 00:01:32.000000001 UTC,_000215,_000214,Stock 1,VectorStock,emit_change,,,,Normal
2025-01-01 00:01:32.000000001 UTC,_000040,_000123,Stock 2,VectorStock,add,41.0,0.9999999999999998,"{""x"":0.09999999999999992,""y"":0.3999999999999997,""z"":0.5000000000000002}",
2025-01-01 00:01:32.000000001 UTC,_000216,_000124,Stock 1,VectorStock,remove,49.99999999999997,0.9999999999999998,"{""x"":0.09999999999999992,""y"":0.3999999999999997,""z"":0.5000000000000002}",
2025-01-01 00:01:32.000000002 UTC,_000217,_000216,Stock 1,VectorStock,emit_change,,,,Empty
2025-01-01 00:01:33 UTC,_000218,_000185,Stock 1,VectorStock,add,50.99999999999997,1.0,"{""x"":0.1,""y"":0.4,""z"":0.5}",
2025-01-01 00:01:33.000000001 UTC,_000219,_000218,Stock 1,VectorStock,emit_change,,,,Normal
2025-01-01 00:01:33.000000001 UTC,_000041,_000126,Stock 2,VectorStock,add,42.0,0.9999999999999998,"{""x"":0.09999999999999992,""y"":0.3999999999999997,""z"":0.5000000000000002}",
2025-01-01 00:01:33.000000001 UTC,_000220,_000127,Stock 1,VectorStock,remove,49.99999999999997,0.9999999999999998,"{""x"":0.09999999999999992,""y"":0.3999999999999997,""z"":0.5000000000000002}",
2025-01-01 00:01:33.000000002 UTC,_000221,_000220,Stock 1,VectorStock,emit_change,,,,Empty
2025-01-01 00:01:34 UTC,_000222,_000187,Stock 1,VectorStock,add,50.99999999999997,1.0,"{""x"":0.1,""y"":0.4,""z"":0.5}",
2025-01-01 00:01:34.000000001 UTC,_000223,_000222,Stock 1,VectorStock,emit_change,,,,Normal
2025-01-01 00:01:34.000000001 UTC,_000042,_000129,Stock 2,VectorStock,add,43.0,0.9999999999999998,"{""x"":0.09999999999999992,""y"":0.3999999999999997,""z"":0.5000000000000002}",
2025-01-01 00:01:34.000000001 UTC,_000224,_000130,Stock 1,VectorStock,remove,49.99999999999997,0.9999999999999998,"{""x"":0.09999999999999992,""y"":0.3999999999999997,""z"":0.5000000000000002}",
2025-01-01 00:01:34.000000002 UTC,_000225,_000224,Stock 1,VectorStock,emit_change,,,,Empty
2025-01-01 00:01:35 UTC,_000226,_000189,Stock 1,VectorStock,add,50.99999999999997,1.0,"{""x"":0.1,""y"":0.4,""z"":0.5}",
2025-01-01 00:01:35.000000001 UTC,_000227,_000226,Stock 1,VectorStock,emit_change,,,,Normal
2025-01-01 00:01:35.000000001 UTC,_000043,_000132,Stock 2,VectorStock,add,44.0,0.9999999999999998,"{""x"":0.09999999999999992,""y"":0.3999999999999997,""z"":0.5000000000000002}",
2025-01-01 00:01:35.000000001 UTC,_000228,_000133,Stock 1,VectorStock,remove,49.99999999999997,0.9999999999999998,"{""x"":0.09999999999999992,""y"":0.3999999999999997,""z"":0.5000000000000002}",
2025-01-01 00:01:35.000000002 UTC,_000229,_000228,Stock 1,VectorStock,emit_change,,,,Empty
2025-01-01 00:01:36 UTC,_000230,_000191,Stock 1,VectorStock,add,50.99999999999997,1.0,"{""x"":0.1,""y"":0.4,""z"":0.5}",
2025-01-01 00:01:36.000000001 UTC,_000231,_000230,Stock 1,VectorStock,emit_change,,,,Normal
2025-01-01 00:01:36.000000001 UTC,_000044,_000135,Stock 2,VectorStock,add,45.0,0.9999999999999998,"{""x"":0.09999999999999992,""y"":0.3999999999999997,""z"":0.5000000000000002}",
2025-01-01 00:01:36.000000001 UTC,_000232,_000136,Stock 1,VectorStock,remove,49.99999999999997,0.9999999999999998,"{""x"":0.09999999999999992,""y"":0.3999999999999997,""z"":0.5000000000000002}",
2025-01-01 00:01:36.000000002 UTC,_000233,_000232,Stock 1,VectorStock,emit_change,,,,Empty
2025-01-01 00:01:37 UTC,_000234,_000193,Stock 1,VectorStock,add,50.99999999999997,1.0,"{""x"":0.1,""y"":0.4,""z"":0.5}",
2025-01-01 00:01:37.000000001 UTC,_000235,_000234,Stock 1,VectorStock,emit_change,,,,Normal
2025-01-01 00:01:37.000000001 UTC,_000045,_000138,Stock 2,VectorStock,add,45.99999999999999,0.9999999999999998,"{""x"":0.09999999999999992,""y"":0.3999999999999997,""z"":0.5000000000000002}",
2025-01-01 00:01:37.000000001 UTC,_000236,_000139,Stock 1,VectorStock,remove,49.99999999999997,0.9999999999999998,"{""x"":0.09999999999999992,""y"":0.3999999999999997,""z"":0.5000000000000002}",
2025-01-01 00:01:37.000000002 UTC,_000237,_000236,Stock 1,VectorStock,emit_change,,,,Empty
2025-01-01 00:01:38 UTC,_000238,_000195,Stock 1,VectorStock,add,50.99999999999997,1.0,"{""x"":0.1,""y"":0.4,""z"":0.5}",
2025-01-01 00:01:38.000000001 UTC,_000239,_000238,Stock 1,VectorStock,emit_change,,,,Normal
2025-01-01 00:01:38.000000001 UTC,_000046,_000141,Stock 2,VectorStock,add,46.999999999999986,0.9999999999999998,"{""x"":0.09999999999999992,""y"":0.3999999999999997,""z"":0.5000000000000002}",
2025-01-01 00:01:38.000000001 UTC,_000240,_000142,Stock 1,VectorStock,remove,49.99999999999997,0.9999999999999998,"{""x"":0.09999999999999992,""y"":0.3999999999999997,""z"":0.5000000000000002}",
2025-01-01 00:01:38.000000002 UTC,_000241,_000240,Stock 1,VectorStock,emit_change,,,,Empty
2025-01-01 00:01:39 UTC,_000242,_000197,Stock 1,VectorStock,add,50.99999999999997,1.0,"{""x"":0.1,""y"":0.4,""z"":0.5}",
2025-01-01 00:01:39.000000001 UTC,_000243,_000242,Stock 1,VectorStock,emit_change,,,,Normal
2025-01-01 00:01:39.000000001 UTC,_000047,_000144,Stock 2,VectorStock,add,47.999999999999986,0.9999999999999998,"{""x"":0.09999999999999992,""y"":0.3999999999999997,""z"":0.5000000000000002}",
2025-01-01 00:01:39.000000001 UTC,_000244,_000145,Stock 1,VectorStock,remove,49.99999999999997,0.9999999999999998,"{""x"":0.09999999999999992,""y"":0.3999999999999997,""z"":0.5000000000000002}",
2025-01-01 00:01:39.000000002 UTC,_000245,_000244,Stock 1,VectorStock,emit_change,,,,Empty
2025-01-01 00:01:40 UTC,_000246,_000199,Stock 1,VectorStock,add,50.99999999999997,1.0,"{""x"":0.1,""y"":0.4,""z"":0.5}",
2025-01-01 00:01:40.000000001 UTC,_000247,_000246,Stock 1,VectorStock,emit_change,,,,Normal
2025-01-01 00:01:40.000000001 UTC,_000048,_000147,Stock 2,VectorStock,add,48.999999999999986,0.9999999999999998,"{""x"":0.09999999999999992,""y"":0.3999999999999997,""z"":0.5000000000000002}",
2025-01-01 00:01:40.000000001 UTC,_000248,_000148,Stock 1,VectorStock,remove,49.99999999999997,0.9999999999999998,"{""x"":0.09999999999999992,""y"":0.3999999999999997,""z"":0.5000000000000002}",
2025-01-01 00:01:40.000000002 UTC,_000249,_000248,Stock 1,VectorStock,emit_change,,,,Empty
2025-01-01 00:01:41 UTC,_000250,_000201,Stock 1,VectorStock,add,50.99999999999997,1.0,"{""x"":0.1,""y"":0.4,""z"":0.5}",
2025-01-01 00:01:41.000000001 UTC,_000251,_000250,Stock 1,VectorStock,emit_change,,,,Normal
2025-01-01 00:01:41.000000001 UTC,_000049,_000150,Stock 2,VectorStock,add,49.999999999999986,0.9999999999999998,"{""x"":0.09999999999999992,""y"":0.3999999999999997,""z"":0.5000000000000002}",
2025-01-01 00:01:41.000000001 UTC,_000252,_000151,Stock 1,VectorStock,remove,49.99999999999997,0.9999999999999998,"{""x"":0.09999999999999992,""y"":0.3999999999999997,""z"":0.5000000000000002}",
2025-01-01 00:01:41.000000002 UTC,_000253,_000252,Stock 1,VectorStock,emit_change,,,,Empty
2025-01-01 00:01:42 UTC,_000254,_000203,Stock 1,VectorStock,add,50.99999999999997,1.0,"{""x"":0.1,""y"":0.4,""z"":0.5}",
2025-01-01 00:01:42.000000001 UTC,_000255,_000254,Stock 1,VectorStock,emit_change,,,,Normal
2025-01-01 00:01:42.000000001 UTC,_000050,_000153,Stock 2,VectorStock,add,50.999999999999986,0.9999999999999998,"{""x"":0.09999999999999992,""y"":0.3999999999999997,""z"":0.5000000000000002}",
2025-01-01 00:01:42.000000001 UTC,_000256,_000154,Stock 1,VectorStock,remove,49.99999999999997,0.9999999999999998,"{""x"":0.09999999999999992,""y"":0.3999999999999997,""z"":0.5000000000000002}",
2025-01-01 00:01:42.000000002 UTC,_000257,_000256,Stock 1,VectorStock,emit_change,,,,Empty
2025-01-01 00:01:42.000000002 UTC,_000051,_000050,Stock 2,VectorStock,emit_change,,,,Normal
2025-01-01 00:01:42.000000002 UTC,_000052,_000001,Stock 2,VectorStock,remove,49.999999999999986,1.0,"{""x"":0.09999999999999996,""y"":0.39999999999999986,""z"":0.5000000000000002}",
2025-01-01 00:01:42.000000003 UTC,_000053,_000052,Stock 2,VectorStock,emit_change,,,,Empty
2025-01-01 00:01:43 UTC,_000258,_000205,Stock 1,VectorStock,add,50.99999999999997,1.0,"{""x"":0.1,""y"":0.4,""z"":0.5}",
2025-01-01 00:01:43.000000001 UTC,_000259,_000258,Stock 1,VectorStock,emit_change,,,,Normal
2025-01-01 00:01:43.000000001 UTC,_000054,_000156,Stock 2,VectorStock,add,50.99999999999998,0.9999999999999998,"{""x"":0.09999999999999992,""y"":0.3999999999999997,""z"":0.5000000000000002}",
2025-01-01 00:01:43.000000001 UTC,_000260,_000157,Stock 1,VectorStock,remove,49.99999999999997,0.9999999999999998,"{""x"":0.09999999999999992,""y"":0.3999999999999997,""z"":0.5000000000000002}",
2025-01-01 00:01:43.000000002 UTC,_000261,_000260,Stock 1,VectorStock,emit_change,,,,Empty
2025-01-01 00:01:43.000000002 UTC,_000055,_000054,Stock 2,VectorStock,emit_change,,,,Normal
2025-01-01 00:01:44 UTC,_000262,_000207,Stock 1,VectorStock,add,50.99999999999997,1.0,"{""x"":0.1,""y"":0.4,""z"":0.5}",
2025-01-01 00:01:44.000000001 UTC,_000263,_000262,Stock 1,VectorStock,emit_change,,,,Normal
2025-01-01 00:01:44.000000001 UTC,_000056,_000159,Stock 2,VectorStock,add,51.99999999999998,0.9999999999999998,"{""x"":0.09999999999999992,""y"":0.3999999999999997,""z"":0.5000000000000002}",
2025-01-01 00:01:44.000000001 UTC,_000264,_000160,Stock 1,VectorStock,remove,49.99999999999997,0.9999999999999998,"{""x"":0.09999999999999992,""y"":0.3999999999999997,""z"":0.5000000000000002}",
2025-01-01 00:01:44.000000002 UTC,_000265,_000264,Stock 1,VectorStock,emit_change,,,,Empty
2025-01-01 00:01:44.000000002 UTC,_000057,_000004,Stock 2,VectorStock,remove,50.99999999999997,0.9999999999999999,"{""x"":0.09999999999999994,""y"":0.39999999999999974,""z"":0.5000000000000002}",
2025-01-01 00:01:45 UTC,_000266,_000209,Stock 1,VectorStock,add,50.99999999999997,1.0,"{""x"":0.1,""y"":0.4,""z"":0.5}",
2025-01-01 00:01:45.000000001 UTC,_000267,_000266,Stock 1,VectorStock,emit_change,,,,Normal
2025-01-01 00:01:45.000000001 UTC,_000058,_000162,Stock 2,VectorStock,add,51.99999999999997,0.9999999999999998,"{""x"":0.09999999999999992,""y"":0.3999999999999997,""z"":0.5000000000000002}",
2025-01-01 00:01:45.000000001 UTC,_000268,_000163,Stock 1,VectorStock,remove,49.99999999999997,0.9999999999999998,"{""x"":0.09999999999999992,""y"":0.3999999999999997,""z"":0.5000000000000002}",
2025-01-01 00:01:45.000000002 UTC,_000269,_000268,Stock 1,VectorStock,emit_change,,,,Empty
2025-01-01 00:01:46 UTC,_000270,_000211,Stock 1,VectorStock,add,50.99999999999997,1.0,"{""x"":0.1,""y"":0.4,""z"":0.5}",
2025-01-01 00:01:46.000000001 UTC,_000271,_000270,Stock 1,VectorStock,emit_change,,,,Normal
2025-01-01 00:01:46.000000001 UTC,_000059,_000165,Stock 2,VectorStock,add,52.99999999999997,0.9999999999999998,"{""x"":0.09999999999999992,""y"":0.3999999999999997,""z"":0.5000000000000002}",
2025-01-01 00:01:46.000000001 UTC,_000272,_000166,Stock 1,VectorStock,remove,49.99999999999997,0.9999999999999998,"{""x"":0.09999999999999992,""y"":0.3999999999999997,""z"":0.5000000000000002}",
2025-01-01 00:01:46.000000002 UTC,_000273,_000272,Stock 1,VectorStock,emit_change,,,,Empty
2025-01-01 00:01:46.000000002 UTC,_000060,_000007,Stock 2,VectorStock,remove,51.99999999999997,1.0,"{""x"":0.09999999999999994,""y"":0.39999999999999974,""z"":0.5000000000000003}",
2025-01-01 00:01:47 UTC,_000274,_000213,Stock 1,VectorStock,add,50.99999999999997,1.0,"{""x"":0.1,""y"":0.4,""z"":0.5}",
2025-01-01 00:01:47.000000001 UTC,_000275,_000274,Stock 1,VectorStock,emit_change,,,,Normal
2025-01-01 00:01:47.000000001 UTC,_000061,_000168,Stock 2,VectorStock,add,52.99999999999997,0.9999999999999998,"{""x"":0.09999999999999992,""y"":0.3999999999999997,""z"":0.5000000000000002}",
2025-01-01 00:01:47.000000001 UTC,_000276,_000169,Stock 1,VectorStock,remove,49.99999999999997,0.9999999999999998,"{""x"":0.09999999999999992,""y"":0.3999999999999997,""z"":0.5000000000000002}",
2025-01-01 00:01:47.000000002 UTC,_000277,_000276,Stock 1,VectorStock,emit_change,,,,Empty
2025-01-01 00:01:48 UTC,_000278,_000215,Stock 1,VectorStock,add,50.99999999999997,1.0,"{""x"":0.1,""y"":0.4,""z"":0.5}",
2025-01-01 00:01:48.000000001 UTC,_000279,_000278,Stock 1,VectorStock,emit_change,,,,Normal
2025-01-01 00:01:48.000000001 UTC,_000062,_000171,Stock 2,VectorStock,add,53.99999999999997,0.9999999999999998,"{""x"":0.09999999999999992,""y"":0.3999999999999997,""z"":0.5000000000000002}",
2025-01-01 00:01:48.000000001 UTC,_000280,_000172,Stock 1,VectorStock,remove,49.99999999999997,0.9999999999999998,"{""x"":0.09999999999999992,""y"":0.3999999999999997,""z"":0.5000000000000002}",
2025-01-01 00:01:48.000000002 UTC,_000281,_000280,Stock 1,VectorStock,emit_change,,,,Empty
2025-01-01 00:01:48.000000002 UTC,_000063,_000010,Stock 2,VectorStock,remove,52.99999999999997,1.0,"{""x"":0.09999999999999992,""y"":0.3999999999999997,""z"":0.5000000000000003}",
2025-01-01 00:01:49 UTC,_000282,_000217,Stock 1,VectorStock,add,50.99999999999997,1.0,"{""x"":0.1,""y"":0.4,""z"":0.5}",
2025-01-01 00:01:49.000000001 UTC,_000283,_000282,Stock 1,VectorStock,emit_change,,,,Normal
2025-01-01 00:01:49.000000001 UTC,_000064,_000174,Stock 2,VectorStock,add,53.99999999999997,0.9999999999999998,"{""x"":0.09999999999999992,""y"":0.3999999999999997,""z"":0.5000000000000002}",
2025-01-01 00:01:49.000000001 UTC,_000284,_000175,Stock 1,VectorStock,remove,49.99999999999997,0.9999999999999998,"{""x"":0.09999999999999992,""y"":0.3999999999999997,""z"":0.5000000000000002}",
2025-01-01 00:01:49.000000002 UTC,_000285,_000284,Stock 1,VectorStock,emit_change,,,,Empty
2025-01-01 00:01:50 UTC,_000286,_000219,Stock 1,VectorStock,add,50.99999999999997,1.0,"{""x"":0.1,""y"":0.4,""z"":0.5}",
2025-01-01 00:01:50.000000001 UTC,_000287,_000286,Stock 1,VectorStock,emit_change,,,,Normal
2025-01-01 00:01:50.000000001 UTC,_000065,_000177,Stock 2,VectorStock,add,54.99999999999997,0.9999999999999998,"{""x"":0.09999999999999992,""y"":0.3999999999999997,""z"":0.5000000000000002}",
2025-01-01 00:01:50.000000001 UTC,_000288,_000178,Stock 1,VectorStock,remove,49.99999999999997,0.9999999999999998,"{""x"":0.09999999999999992,""y"":0.3999999999999997,""z"":0.5000000000000002}",
2025-01-01 00:01:50.000000002 UTC,_000289,_000288,Stock 1,VectorStock,emit_change,,,,Empty
2025-01-01 00:01:50.000000002 UTC,_000066,_000013,Stock 2,VectorStock,remove,53.99999999999997,1.0,"{""x"":0.09999999999999992,""y"":0.3999999999999997,""z"":0.5000000000000003}",
2025-01-01 00:01:51 UTC,_000290,_000221,Stock 1,VectorStock,add,50.99999999999997,1.0,"{""x"":0.1,""y"":0.4,""z"":0.5}",
2025-01-01 00:01:51.000000001 UTC,_000291,_000290,Stock 1,VectorStock,emit_change,,,,Normal
2025-01-01 00:01:51.000000001 UTC,_000067,_000180,Stock 2,VectorStock,add,54.99999999999997,0.9999999999999998,"{""x"":0.09999999999999992,""y"":0.3999999999999997,""z"":0.5000000000000002}",
2025-01-01 00:01:51.000000001 UTC,_000292,_000181,Stock 1,VectorStock,remove,49.99999999999997,0.9999999999999998,"{""x"":0.09999999999999992,""y"":0.3999999999999997,""z"":0.5000000000000002}",
2025-01-01 00:01:51.000000002 UTC,_000293,_000292,Stock 1,VectorStock,emit_change,,,,Empty
2025-01-01 00:01:52 UTC,_000294,_000223,Stock 1,VectorStock,add,50.99999999999997,1.0,"{""x"":0.1,""y"":0.4,""z"":0.5}",
2025-01-01 00:01:52.000000001 UTC,_000295,_000294,Stock 1,VectorStock,emit_change,,,,Normal
2025-01-01 00:01:52.000000001 UTC,_000068,_000183,Stock 2,VectorStock,add,55.99999999999997,0.9999999999999998,"{""x"":0.09999999999999992,""y"":0.3999999999999997,""z"":0.5000000000000002}",
2025-01-01 00:01:52.000000001 UTC,_000296,_000184,Stock 1,VectorStock,remove,49.99999999999997,0.9999999999999998,"{""x"":0.09999999999999992,""y"":0.3999999999999997,""z"":0.5000000000000002}",
2025-01-01 00:01:52.000000002 UTC,_000297,_000296,Stock 1,VectorStock,emit_change,,,,Empty
2025-01-01 00:01:52.000000002 UTC,_000069,_000016,Stock 2,VectorStock,remove,54.999999999999964,1.0,"{""x"":0.09999999999999992,""y"":0.3999999999999997,""z"":0.5000000000000003}",
2025-01-01 00:01:53 UTC,_000298,_000225,Stock 1,VectorStock,add,50.99999999999997,1.0,"{""x"":0.1,""y"":0.4,""z"":0.5}",
2025-01-01 00:01:53.000000001 UTC,_000299,_000298,Stock 1,VectorStock,emit_change,,,,Normal
2025-01-01 00:01:53.000000001 UTC,_000070,_000186,Stock 2,VectorStock,add,55.99999999999996,0.9999999999999998,"{""x"":0.09999999999999992,""y"":0.3999999999999997,""z"":0.5000000000000002}",
2025-01-01 00:01:53.000000001 UTC,_000300,_000187,Stock 1,VectorStock,remove,49.99999999999997,0.9999999999999998,"{""x"":0.09999999999999992,""y"":0.3999999999999997,""z"":0.5000000000000002}",
2025-01-01 00:01:53.000000002 UTC,_000301,_000300,Stock 1,VectorStock,emit_change,,,,Empty
2025-01-01 00:01:54 UTC,_000302,_000227,Stock 1,VectorStock,add,50.99999999999997,1.0,"{""x"":0.1,""y"":0.4,""z"":0.5}",
2025-01-01 00:01:54.000000001 UTC,_000303,_000302,Stock 1,VectorStock,emit_change,,,,Normal
2025-01-01 00:01:54.000000001 UTC,_000071,_000189,Stock 2,VectorStock,add,56.99999999999996,0.9999999999999998,"{""x"":0.09999999999999992,""y"":0.3999999999999997,""z"":0.5000000000000002}",
2025-01-01 00:01:54.000000001 UTC,_000304,_000190,Stock 1,VectorStock,remove,49.99999999999997,0.9999999999999998,"{""x"":0.09999999999999992,""y"":0.3999999999999997,""z"":0.5000000000000002}",
2025-01-01 00:01:54.000000002 UTC,_000305,_000304,Stock 1,VectorStock,emit_change,,,,Empty
2025-01-01 00:01:54.000000002 UTC,_000072,_000019,Stock 2,VectorStock,remove,55.99999999999996,1.0,"{""x"":0.09999999999999992,""y"":0.3999999999999997,""z"":0.5000000000000004}",
2025-01-01 00:01:55 UTC,_000306,_000229,Stock 1,VectorStock,add,50.99999999999997,1.0,"{""x"":0.1,""y"":0.4,""z"":0.5}",
2025-01-01 00:01:55.000000001 UTC,_000307,_000306,Stock 1,VectorStock,emit_change,,,,Normal
2025-01-01 00:01:55.000000001 UTC,_000073,_000192,Stock 2,VectorStock,add,56.99999999999996,0.9999999999999998,"{""x"":0.09999999999999992,""y"":0.3999999999999997,""z"":0.5000000000000002}",
2025-01-01 00:01:55.000000001 UTC,_000308,_000193,Stock 1,VectorStock,remove,49.99999999999997,0.9999999999999998,"{""x"":0.09999999999999992,""y"":0.3999999999999997,""z"":0.5000000000000002}",
2025-01-01 00:01:55.000000002 UTC,_000309,_000308,Stock 1,VectorStock,emit_change,,,,Empty
2025-01-01 00:01:56 UTC,_000310,_000231,Stock 1,VectorStock,add,50.99999999999997,1.0,"{""x"":0.1,""y"":0.4,""z"":0.5}",
2025-01-01 00:01:56.000000001 UTC,_000311,_000310,Stock 1,VectorStock,emit_change,,,,Normal
2025-01-01 00:01:56.000000001 UTC,_000074,_000195,Stock 2,VectorStock,add,57.99999999999996,0.9999999999999998,"{""x"":0.09999999999999992,""y"":0.3999999999999997,""z"":0.5000000000000002}",
2025-01-01 00:01:56.000000001 UTC,_000312,_000196,Stock 1,VectorStock,remove,49.99999999999997,0.9999999999999998,"{""x"":0.09999999999999992,""y"":0.3999999999999997,""z"":0.5000000000000002}",
2025-01-01 00:01:56.000000002 UTC,_000313,_000312,Stock 1,VectorStock,emit_change,,,,Empty
2025-01-01 00:01:56.000000002 UTC,_000075,_000022,Stock 2,VectorStock,remove,56.99999999999996,1.0,"{""x"":0.09999999999999991,""y"":0.39999999999999963,""z"":0.5000000000000004}",
2025-01-01 00:01:57 UTC,_000314,_000233,Stock 1,VectorStock,add,50.99999999999997,1.0,"{""x"":0.1,""y"":0.4,""z"":0.5}",
2025-01-01 00:01:57.000000001 UTC,_000315,_000314,Stock 1,VectorStock,emit_change,,,,Normal
2025-01-01 00:01:57.000000001 UTC,_000076,_000198,Stock 2,VectorStock,add,57.99999999999996,0.9999999999999998,"{""x"":0.09999999999999992,""y"":0.3999999999999997,""z"":0.5000000000000002}",
2025-01-01 00:01:57.000000001 UTC,_000316,_000199,Stock 1,VectorStock,remove,49.99999999999997,0.9999999999999998,"{""x"":0.09999999999999992,""y"":0.3999999999999997,""z"":0.5000000000000002}",
2025-01-01 00:01:57.000000002 UTC,_000317,_000316,Stock 1,VectorStock,emit_change,,,,Empty
2025-01-01 00:01:58 UTC,_000318,_000235,Stock 1,VectorStock,add,50.99999999999997,1.0,"{""x"":0.1,""y"":0.4,""z"":0.5}",
2025-01-01 00:01:58.000000001 UTC,_000319,_000318,Stock 1,VectorStock,emit_change,,,,Normal
2025-01-01 00:01:58.000000001 UTC,_000077,_000201,Stock 2,VectorStock,add,58.99999999999996,0.9999999999999998,"{""x"":0.09999999999999992,""y"":0.3999999999999997,""z"":0.5000000000000002}",
2025-01-01 00:01:58.000000001 UTC,_000320,_000202,Stock 1,VectorStock,remove,49.99999999999997,0.9999999999999998,"{""x"":0.09999999999999992,""y"":0.3999999999999997,""z"":0.5000000000000002}",
2025-01-01 00:01:58.000000002 UTC,_000321,_000320,Stock 1,VectorStock,emit_change,,,,Empty
2025-01-01 00:01:58.000000002 UTC,_000078,_000025,Stock 2,VectorStock,remove,57.99999999999994,1.0,"{""x"":0.09999999999999991,""y"":0.39999999999999963,""z"":0.5000000000000004}",
2025-01-01 00:01:59 UTC,_000322,_000237,Stock 1,VectorStock,add,50.99999999999997,1.0,"{""x"":0.1,""y"":0.4,""z"":0.5}",
2025-01-01 00:01:59.000000001 UTC,_000323,_000322,Stock 1,VectorStock,emit_change,,,,Normal
2025-01-01 00:01:59.000000001 UTC,_000079,_000204,Stock 2,VectorStock,add,58.99999999999994,0.9999999999999998,"{""x"":0.09999999999999992,""y"":0.3999999999999997,""z"":0.5000000000000002}",
2025-01-01 00:01:59.000000001 UTC,_000324,_000205,Stock 1,VectorStock,remove,49.99999999999997,0.9999999999999998,"{""x"":0.09999999999999992,""y"":0.3999999999999997,""z"":0.5000000000000002}",
2025-01-01 00:01:59.000000002 UTC,_000325,_000324,Stock 1,VectorStock,emit_change,,,,Empty
2025-01-01 00:02:00 UTC,_000326,_000239,Stock 1,VectorStock,add,50.99999999999997,1.0,"{""x"":0.1,""y"":0.4,""z"":0.5}",
